# Gboard Dictionary version:1
ああるむら	アアル村	ja-JP
あうたけへいげん	アウタケ平原	ja-JP
あかつきわいなりー	アカツキワイナリー	ja-JP
あくしょんかーど	アクションカード	ja-JP
あくしょんふぇーず	アクションフェーズ	ja-JP
あさせじんじゃ	浅瀬神社	ja-JP
あさせひびき	浅瀬響	ja-JP
あしぱとら・ゔぁなのぬま	アシパトラ・ヴァナの沼	ja-JP
あしぱとらゔぁなのぬま	アシパトラ・ヴァナの沼	ja-JP
あしゃゔぁんれるむ	アシャヴァンレルム	ja-JP
あすとろまんさー・ばーべろす・とりすめぎすとす	アストロマンサー・バーベロス・トリスメギストス	ja-JP
あぞすぶっしつ	アゾス物質	ja-JP
あつこ	竺子	ja-JP
あぱーむそうりん	アパーム叢林	ja-JP
あびさるゔぃしゃっぷ	アビサルヴィシャップ	ja-JP
あびさるどらごえあ	アビサルドラゴエア	ja-JP
あびすのえいしょうしゃ	アビスの詠唱者	ja-JP
あびすのしと	アビスの使徒	ja-JP
あびでぃあのもり	アビディアの森	ja-JP
あふまる	アフマル	ja-JP
あふらしあぶどうくつ	アフラシアブ洞窟	ja-JP
あぺぷ	アペプ	ja-JP
あぺぷのおあしすしゅごしゃ	アペプのオアシス守護者	ja-JP
あまかねじま	甘金島	ja-JP
あまくもくさ	天雲草	ja-JP
あまぐもくさ	天雲草	ja-JP
あまくもそう	天雲草	ja-JP
あまぐもそう	天雲草	ja-JP
あまくもとうげ	天雲峠	ja-JP
あめのま	天目	ja-JP
あめのまりゅう	天目流	ja-JP
あやか	綾華	ja-JP
あやっくす	アヤックス	ja-JP
あやと	綾人	ja-JP
あらいしのそうばく	荒石の蒼漠	ja-JP
あらうみ	荒海	ja-JP
あらたきいっと	荒瀧一斗	ja-JP
あらんなら	アランナラ	ja-JP
あらんらからり	アランラカラリ	ja-JP
ありす	アリス	ja-JP
ある・すーくるきゅうでん	アル・スークル宮殿	ja-JP
ある・ぬはすのみやこ	アル・ヌハスの都	ja-JP
ある・むあざんきゅうでん	アル・ムアザン宮殿	ja-JP
あるあじふのすな	アル・アジフの砂	ja-JP
あるいんきだのあんぐう	アル・インキダの行宮	ja-JP
あるかさるざらいぱれす	アルカサルザライパレス	ja-JP
あるけー	アルケー	ja-JP
あるすーくるきゅうでん	アル・スークル宮殿	ja-JP
あるだらびかこく	アルダラビ河谷	ja-JP
あるぬはすのみやこ	アル・ヌハスの都	ja-JP
あるはいぜん	アルハイゼン	ja-JP
あるべど	アルベド	ja-JP
あるまじゅじきょうこく	アル・マジュジ峡谷	ja-JP
あるむあざんきゅうでん	アル・ムアザン宮殿	ja-JP
あるれっきーの	アルレッキーノ	ja-JP
あわあわたつのこ	アワアワタツノコ	ja-JP
あんじぇりっくあぷりしあ	アンジェリックアプリシア	ja-JP
あんでしゅどってる	アンデシュドッテル	ja-JP
あんどりあす	アンドリアス	ja-JP
あんばー	アンバー	ja-JP
あんみんのち	安眠の地	ja-JP
いあんさ	イアンサ	ja-JP
いーすと・えすすさんろく	イースト・エスス山麓	ja-JP
いーすと・おとんぬき	イースト・オトンヌキ	ja-JP
いーすとえすすさんろく	イースト・エスス山麓	ja-JP
いーすとおとんぬき	イースト・オトンヌキ	ja-JP
いーでぃす	イーディス	ja-JP
いぇらん	夜蘭	ja-JP
いぐさ	イグサ	ja-JP
いすたろと	イスタロト	ja-JP
いせききへい	遺跡機兵	ja-JP
いせきさーぺんと	遺跡サーペント	ja-JP
いせきじゅんししゃ	遺跡巡視者	ja-JP
いせきせんめつしゃ	遺跡殲滅者	ja-JP
いせきていしゃつしゃ	遺跡偵察者	ja-JP
いせきどれいく	遺跡ドレイク	ja-JP
いせきぼうえいしゃ	遺跡防衛者	ja-JP
いっしんでん	一心伝	ja-JP
いなずまじょう	稲妻城	ja-JP
いのちのせいざ	命ノ星座	ja-JP
いぷししますのとう	イプシシマスの塔	ja-JP
いべんとかーど	イベントカード	ja-JP
いむのようばい	異夢の溶媒	ja-JP
いらいにんむ	依頼任務	ja-JP
いんていわっと	インテイワット	ja-JP
いんろんは	因論派	ja-JP
ゔぁーな	ヴァーナ	ja-JP
ゔぁざーりかいろう	ヴァザーリ回廊	ja-JP
ゔぁなき	ヴァナキ	ja-JP
ゔぁならーな	ヴァナラーナ	ja-JP
ゔぁねっさ	ヴァネッサ	ja-JP
ゔぃしゃっぷ	ヴィシャップ	ja-JP
ゔぃしゅっだへんど	ヴィシュッダ辺土	ja-JP
ゔぃぱりゃす	ヴィパリャス	ja-JP
ゔぃまらむら	ヴィマラ村	ja-JP
うーしあ	ウーシア	ja-JP
うぇすと・おとんぬき	ウェスト・オトンヌキ	ja-JP
うぇすとおとんぬき	ウェスト・オトンヌキ	ja-JP
ゔぇずるふぇるにる	ヴェズルフェルニル	ja-JP
うぇねと	ウェネト	ja-JP
うぇねととんねる	ウェネトトンネル	ja-JP
うぇるぷ	ウェルプ	ja-JP
うぇんてぃ	ウェンティ	ja-JP
うさぎはくしゃく	ウサギ伯爵	ja-JP
うどぅんばら	ウドゥンバラ	ja-JP
うみぞめしゃこ	海染硨磲	ja-JP
うみれいし	ウミレイシ	ja-JP
うらくさい	有楽斎	ja-JP
うらにあこ	ウラニア湖	ja-JP
うんかんしゃ	雲翰社	ja-JP
うんきん	雲菫	ja-JP
うんらいのうみ	雲来の海	ja-JP
えい	影	ja-JP
えいえんのおあしす	永遠のオアシス	ja-JP
えうるあ	エウルア	ja-JP
えげりあ	エゲリア	ja-JP
えっさんしゅ	謁賛主	ja-JP
えばはーと	エバハート	ja-JP
えぴくれしすかげきじょう	エピクレシス歌劇場	ja-JP
えりなす	エリナス	ja-JP
えりなす	エリナス	ja-JP
えりにゅすさんりんちく	エリニュス山林地区	ja-JP
えりにゅすとう	エリニュス島	ja-JP
えりん	エリン	ja-JP
えるとんかいこう	エルトン海溝	ja-JP
えるまいとりょだん	エルマイト旅団	ja-JP
えるみん	エルミン	ja-JP
えれんどりん	エレンドリン	ja-JP
えんかいこうせき	淵海鉱石	ja-JP
えんかのみや	淵下宮	ja-JP
えんげつらせん	淵月螺旋	ja-JP
えんしぇんとゔぃしゃっぷ	エンシェントヴィシャップ	ja-JP
えんじょう	淵上	ja-JP
えんどふぇーず	エンドフェーズ	ja-JP
えんひ	煙緋	ja-JP
おうごんおうじゅう	黄金王獣	ja-JP
おうごんのげきだん	黄金の劇団	ja-JP
おうごんや	黄金屋	ja-JP
おうじゅのかご	王樹の加護	ja-JP
おうじょうどう	往生堂	ja-JP
おうたつ	応達	ja-JP
おおがたがれきぶりーちゃーぷりむす	大型瓦礫ブリーチャープリムス	ja-JP
おおがたきょうまんぶりーちゃーぷりむす	大型狂蔓ブリーチャープリムス	ja-JP
おくぞうさん	奥蔵山	ja-JP
おせる	オセル	ja-JP
おとぎざい	御伽材	ja-JP
おるまずど	オルマズド	ja-JP
おるまずどしゃー	オルマズドシャー	ja-JP
おるもすこう	オルモス港	ja-JP
おろばし	オロバシ	ja-JP
おろばしのみこと	オロバシノミコト	ja-JP
かーゔぇ	カーヴェ	ja-JP
かーたー	カーター	ja-JP
かーれすせん	カーレス線	ja-JP
かーんるいあ	カーンルイア	ja-JP
がいあ	ガイア	ja-JP
かいこう	廻光	ja-JP
かいせい	廻聖	ja-JP
かいせんしゃこ	海染硨磲	ja-JP
かいとうさい	海灯祭	ja-JP
かいらぎ	海乱鬼	ja-JP
かえでざい	楓材	ja-JP
かえではら	楓原	ja-JP
かえではらかずは	楓原万葉	ja-JP
かかた	カカタ	ja-JP
かかん	華館	ja-JP
かかんむせいけいがいき	華館夢醒形骸記	ja-JP
かこうのりん	華光の林	ja-JP
かしん	花神	ja-JP
かしんたんさい	花神誕祭	ja-JP
かしんたんじつ	花神誕日	ja-JP
かずは	万葉	ja-JP
かぜうなりのおか	風唸りの丘	ja-JP
かぜたちのち	風立ちの地	ja-JP
かぜのゆくえ	風の行方	ja-JP
かっつぇれいん	カッツェレイン	ja-JP
かばざい	樺材	ja-JP
かぴたーの	カピターノ	ja-JP
かふぇ・るつぇるん	カフェ・ルツェルン	ja-JP
かふぇるつぇるん	カフェ・ルツェルン	ja-JP
かみさと	神里	ja-JP
かみさとあやか	神里綾華	ja-JP
かみさとあやと	神里綾人	ja-JP
かみさとやしき	神里屋敷	ja-JP
かみのごばん	神の碁盤	ja-JP
かみのめ	神の目	ja-JP
かみふうしょくち	上風蝕地	ja-JP
かむなはるのすけ	惟神晴之介	ja-JP
かりゅぶでぃすとりであと	カリュブディス砦跡	ja-JP
かるぱらたはす	カルパラタ蓮	ja-JP
かれい	花霊	ja-JP
がれきぶりーちゃーぷりむす	瓦礫ブリーチャープリムス	ja-JP
かんう	甘雨	ja-JP
がんおうていくん	岩王帝君	ja-JP
がんだおか	ガンダ丘	ja-JP
がんだるゔぁーむら	ガンダルヴァー村	ja-JP
かんづめちしき	缶詰知識	ja-JP
かんなざん	カンナ山	ja-JP
かんなづか	神無塚	ja-JP
かんろかかい	甘露花海	ja-JP
かんろかっすい	甘露活水	ja-JP
きかんきたん	機関棋譚	ja-JP
きこうざい	輝光材	ja-JP
きしゅう	帰終	ja-JP
きせい	祈聖	ja-JP
きせいのえきす	祈聖のエキス	ja-JP
きせいのおいる	祈聖のオイル	ja-JP
きっこうちゅう	吉光虫	ja-JP
きつねさいぐう	狐斎宮	ja-JP
きのこん	キノコン	ja-JP
きのしし	キノシシ	ja-JP
きのち	岐の地	ja-JP
きぼうのみち	希望の道	ja-JP
きゃっつてーる	キャッツテール	ja-JP
きゃらえりあ	キャラエリア	ja-JP
きゃらかーど	キャラカード	ja-JP
きゃらばんしゅくえき	キャラバン宿駅	ja-JP
きゃらふぞく	キャラ付属	ja-JP
きゃんでぃす	キャンディス	ja-JP
きゅうぐう	旧宮	ja-JP
きゅうぞう	弓蔵	ja-JP
きゅうとうじゅ	急凍樹	ja-JP
きよいずみちょう	清泉町	ja-JP
ぎょうこう	凝光	ja-JP
きょうまんぶりーちゃーぷりむす	狂蔓ブリーチャープリムス	ja-JP
きょうりつてい	共律庭	ja-JP
きょうれいいん	教令院	ja-JP
きょえんしゅこうく	巨淵主鉱区	ja-JP
きょえんほらぐち	巨淵洞口	ja-JP
きょじゃがんけつ	巨蛇岩穴	ja-JP
ぎよたん	ギヨタン	ja-JP
きらら	綺良々	ja-JP
きりぎりのかいこう	霧切の廻光	ja-JP
きりのゆうりんどう	霧の幽林道	ja-JP
きりはら	帰離原	ja-JP
きんぐでしぇれと	キングデシェレト	ja-JP
きんぐでしぇれとのれいびょう	キングデシェレトの霊廟	ja-JP
きんはく	金珀	ja-JP
きんぱく	金珀	ja-JP
きんほう	金鵬	ja-JP
きんりんごぐんとう	金リンゴ群島	ja-JP
くいっくあくしょん	クイックアクション	ja-JP
ぐぅおぱぁー	グゥオパァー	ja-JP
くき	久岐	ja-JP
くきしのぶ	久岐忍	ja-JP
ぐぐぷらむ	ググプラム	ja-JP
くじゃくざい	孔雀材	ja-JP
くじょうさら	九条裟羅	ja-JP
くじょうじんや	九条陣屋	ja-JP
くにくずし	国崩	ja-JP
くらくさなりでび	クラクサナリデビ	ja-JP
くらばれったさん	クラバレッタさん	ja-JP
ぐらんどばざーる	グランドバザール	ja-JP
くりぷす	クリプス	ja-JP
くるーずちか	クルーズチカ	ja-JP
ぐるぐるかみなりきのこん	グルグル雷キノコン	ja-JP
ぐるぐるこおりきのこん	グルグル氷キノコン	ja-JP
ぐるぐるほのおきのこん	グルグル炎キノコン	ja-JP
くれー	クレー	ja-JP
ぐれーと・ふぉんてーぬ・れいく	グレート・フォンテーヌ・レイク	ja-JP
ぐれーとふぉんてーぬれいく	グレート・フォンテーヌ・レイク	ja-JP
くれめんたいんせん	クレメンタイン線	ja-JP
くろっくわーく・ましなりー	クロックワーク・マシナリー	ja-JP
くろっくわーくましなりー	クロックワーク・マシナリー	ja-JP
くろりんで	クロリンデ	ja-JP
ぐんぎょくかく	群玉閣	ja-JP
ぐんひるど	グンヒルド	ja-JP
けいうんちょう	慶雲頂	ja-JP
けいきや	瓊璣野	ja-JP
けいこうあいろ	蛍光隘路	ja-JP
けいさくそう	軽策荘	ja-JP
げいしょうばな	霓裳花	ja-JP
けいほうし	蛍胞子	ja-JP
げいるはんたー	ゲイルハンター	ja-JP
げしゅたるとう	ゲシュタル塔	ja-JP
けったく	竭沢	ja-JP
けつたく	竭沢	ja-JP
けわしきせきどう	嶮しき石堂	ja-JP
げんかいあべらんと	原海アベラント	ja-JP
げんかいしゅんのつの	原海駿の角	ja-JP
げんげきか	原激化	ja-JP
げんしたいかい	原始胎海	ja-JP
げんしたいかいのみず	原始胎海の水	ja-JP
けんじゅんじゅうこうやどかに	堅盾重甲ヤドカニ	ja-JP
げんしょう	言笑	ja-JP
げんしょのあのかた	原初のあの方	ja-JP
げんしん	原神	ja-JP
げんせき	原石	ja-JP
げんそきょうめい	元素共鳴	ja-JP
げんそさいころ	元素サイコロ	ja-JP
げんそじゅくち	元素熟知	ja-JP
げんそすきる	元素スキル	ja-JP
げんそちゃーじ	元素チャージ	ja-JP
げんそちょうわ	元素調和	ja-JP
げんそばくはつ	元素爆発	ja-JP
げんそはんのう	元素反応	ja-JP
ごうかざい	業果材	ja-JP
こうかすがたのいろどりさい	光華容彩祭	ja-JP
こうじょうからくりじんけい	恒常からくり陣形	ja-JP
こうせつ	江雪	ja-JP
こうちゅう	匣中	ja-JP
こうちゅうめつりゅう	匣中滅龍	ja-JP
こうちゅうりゅうぎん	匣中龍吟	ja-JP
こうまたいせい	降魔大聖	ja-JP
こうりんしゃ	降臨者	ja-JP
こうんかく	孤雲閣	ja-JP
こかは	古華派	ja-JP
ごくあくき	極悪騎	ja-JP
こくさい	黒災	ja-JP
こくじゃきし	黒蛇騎士	ja-JP
こくせい	刻晴	ja-JP
こぐのすふぃあ	COGNOSPHERE	ja-JP
ここうのすずらん	湖光の鈴蘭	ja-JP
ここなっつひつじ	ココナッツヒツジ	ja-JP
ここみ	心海	ja-JP
こせきむら	越石村	ja-JP
ごだいおあしすのいこう	「五大オアシス」の遺構	ja-JP
こちゅうのうぃーぴんぐうぃろー	湖中のウィーピングウィロー	ja-JP
こっけん	黒剣	ja-JP
ごほうやしゃ	護法夜叉	ja-JP
こまにや	狛荷屋	ja-JP
ごまのつえ	護摩の杖	ja-JP
こもれちゃや	木漏茶屋	ja-JP
こりゅばんてす	コリュバンテス	ja-JP
これあんばー	コレアンバー	ja-JP
これい	コレイ	ja-JP
ころうざん	琥牢山	ja-JP
ごろー	ゴロー	ja-JP
ころんびーな	コロンビーナ	ja-JP
こんだむら	紺田村	ja-JP
ざ・らすてぃ・らだー	ザ・ラスティ・ラダー	ja-JP
さーんどる	サーンドル	ja-JP
さーんどるがわ	サーンドル河	ja-JP
さーんどるのわたしもり	サーンドルの渡し守	ja-JP
ざいとぅんとう	ザイトゥン桃	ja-JP
さいふぉす	サイフォス	ja-JP
さうまらたはす	サウマラタ蓮	ja-JP
さくげつちくようしんくん	削月築陽真君	ja-JP
ささやきのもり	囁きの森	ja-JP
ささゆり	笹百合	ja-JP
さしよう	砂脂蛹	ja-JP
さみしいばしょ	さみしい場所	ja-JP
さむぞらのくぎ	寒天の釘	ja-JP
さむどらかいがん	サムドラ海岸	ja-JP
さゆ	早柚	ja-JP
さら	裟羅	ja-JP
さらしあうなばら	サラシア海原	ja-JP
さりぶ	サリブ	ja-JP
さりぶ・どーれい	サリブ・ドーレイ	ja-JP
さるば	サルバ	ja-JP
さんうんがのち	三運河の地	ja-JP
さんかい	三界	ja-JP
さんかいみちあえのまつり	三界道饗祭	ja-JP
さんぐいと	サングイト	ja-JP
さんぐまはべい	サングマハベイ	ja-JP
さんごのみや	珊瑚宮	ja-JP
さんごのみや	珊瑚宮	ja-JP
さんごのみやここみ	珊瑚宮心海	ja-JP
さんどうぉーたー	サンドウォーター	ja-JP
さんどろあますたー	サンドロアマスター	ja-JP
さんどろーね	サンドローネ	ja-JP
ざんひょう	散兵	ja-JP
さんふろすと	サンフロスト	ja-JP
さんりょうぶっしつへんかき	参量物質変化器	ja-JP
しいき	死域	ja-JP
しーどるこ	シードル湖	ja-JP
しーむるぐ	シームルグ	ja-JP
じぇいこぶ	ジェイコブ	ja-JP
しぇろい	シェロイ	ja-JP
しえんえりあ	支援エリア	ja-JP
しえんかーど	支援カード	ja-JP
じぇんとるまん・あっしゃー	ジェントルマン・アッシャー	ja-JP
しかのいん	鹿野院	ja-JP
しかのいんへいぞう	鹿野院平蔵	ja-JP
しぐうぃん	シグウィン	ja-JP
しせん	志璇	ja-JP
しぜんてつがくがくいん	自然哲学学院	ja-JP
しちしん	七神	ja-JP
しちせいしょうかん	七聖召喚	ja-JP
しちてんじんぞう	七天神像	ja-JP
しちょうせいごう	死兆星号	ja-JP
しっきゃくのたに	失脚の谷	ja-JP
じっけんようふぃーるどせいせいそうち	実験用フィールド生成装置	ja-JP
しつりつてい	執律庭	ja-JP
しなばーすぴんどる	シナバースピンドル	ja-JP
しにょーら	シニョーラ	ja-JP
しふうげんてん	四風原典	ja-JP
しふうしゅご	四風守護	ja-JP
しもふうしょくち	下風蝕地	ja-JP
しゃーる・ふぃんどにーる	シャール・フィンドニール	ja-JP
しゃくせきのおか	鑠石の丘	ja-JP
じゃくだりゅうおう	若陀龍王	ja-JP
しゃこ	硨磲	ja-JP
じゃこつこうこう	蛇骨鉱坑	ja-JP
じゃしんのち	蛇心の地	ja-JP
しゃしんのみち	捨身の坑	ja-JP
じゃちょうのみち	蛇腸の道	ja-JP
しゃどうはすく	シャドウハスク	ja-JP
しゃるろっと	シャルロット	ja-JP
しゃんりん	香菱	ja-JP
しゅゔぁるまらんふじん	シュヴァルマラン婦人	ja-JP
じゅういき	獣域	ja-JP
じゅういきうぇるぷ	獣域ウェルプ	ja-JP
じゅういきおうき	獣域王器	ja-JP
じゅういきはうんど	獣域ハウンド	ja-JP
じゅうこうやどかに	重甲ヤドカニ	ja-JP
しゅうまつばん	終末番	ja-JP
しゅゔるーず	シュヴルーズ	ja-JP
じゅらばど	ジュラバド	ja-JP
しゅりょうとうえい	狩猟刀エイ	ja-JP
じゅんすいせいれい	純水精霊	ja-JP
じゅんすいせん	巡水船	ja-JP
しょう	魈	ja-JP
しょうかく	晶核	ja-JP
しょうかこつずい	晶化骨髄	ja-JP
しょうかんぶつえりあ	召喚物エリア	ja-JP
しょうきのかみ	正機の神	ja-JP
じょうこうのはね	浄光の羽根	ja-JP
しょうござい	証悟材	ja-JP
しょうちょう	晶蝶	ja-JP
しょうちょうとらっぷそうち	晶蝶トラップ装置	ja-JP
しょうとう	霄灯	ja-JP
しょうほうし	晶胞子	ja-JP
しょうり	鍾離	ja-JP
しりころやま	シリコロ山	ja-JP
しりん	シリン	ja-JP
しるゔぁ	シルヴァ	ja-JP
じん	ジン	ja-JP
しんえん	辛炎	ja-JP
しんおう	神櫻	ja-JP
しんかく	申鶴	ja-JP
じんかつぼ	塵歌壺	ja-JP
しんきょうらせん	深境螺旋	ja-JP
しんざいのしんれいしゃ	深罪の浸礼者	ja-JP
しんしゃおうじょうろく	辰砂往生録	ja-JP
じんじゃくかい	燼寂海	ja-JP
しんじゅのうた	真珠の歌	ja-JP
しんちゅう	神鋳	ja-JP
しんちゅうふけい	神鋳賦形	ja-JP
しんちゅうめいてい	神鋳命定	ja-JP
じんでんじゅ	迅電樹	ja-JP
じんにー	ジンニー	ja-JP
しんふぉんてーぬかがくいん	新フォンテーヌ科学院	ja-JP
すいかざい	萃華材	ja-JP
すいぎょうしょう	萃凝晶	ja-JP
すいきんかく	衰菌核	ja-JP
すいけいたるぱ	水形タルパ	ja-JP
すいけつざか	翠決坡	ja-JP
すいげつち	水月池	ja-JP
すいこうざい	垂香材	ja-JP
すいせんじゅうじいん	水仙十字院	ja-JP
すいせんじゅうじけっしゃ	水仙十字結社	ja-JP
すうりつてい	枢律庭	ja-JP
すかーく	スカーク	ja-JP
すがたのいろどりさい	容彩祭	ja-JP
すからましゅ	スカラマシュ	ja-JP
すぎざい	杉材	ja-JP
すくろーす	スクロース	ja-JP
すけぷてぃっくだん	スケプティック団	ja-JP
すちーむばーどしんぶんしゃ	スチームバード新聞社	ja-JP
すとーんえんちゃんたー	ストーンエンチャンター	ja-JP
すなのめ	砂の目	ja-JP
すねーじなや	スネージナヤ	ja-JP
すねーじなやぱれす	スネージナヤパレス	ja-JP
ずばいるしあたー	ズバイルシアター	ja-JP
すぴな・でぃ・ろーすら	棘薔薇の会	ja-JP
すぴなでぃろーすら	棘薔薇の会	ja-JP
すぴのくろこ	スピノクロコ	ja-JP
すめーる	スメール	ja-JP
すめーるしてぃ	スメールシティ	ja-JP
すめーるろーず	スメールローズ	ja-JP
ずるゔぁーん	ズルヴァーン	ja-JP
するとろっち	スルトロッチ	ja-JP
せいがいあかわし	聖骸赤鷲	ja-JP
せいがいがじゅう	聖骸牙獣	ja-JP
せいがいさそり	聖骸サソリ	ja-JP
せいがいじゅう	聖骸獣	ja-JP
せいがいとびへび	聖骸トビヘビ	ja-JP
せいがいとびへび	聖骸ツノワニ	ja-JP
せいきょうら	青墟浦	ja-JP
せいぎんこうせき	星銀鉱石	ja-JP
せいきんちゅう	聖金虫	ja-JP
せいけん	聖顕	ja-JP
せいけんでん	聖顕殿	ja-JP
せいけんのかぎ	聖顕の鍵	ja-JP
せいこうのさきゅう	精鋼の砂丘	ja-JP
せいこんちゅう	聖金虫	ja-JP
ぜいじゃくじゅし	脆弱樹脂	ja-JP
せいもあ	セイモア	ja-JP
せいら	星螺	ja-JP
せいらいじま	セイライ島	ja-JP
せいらいまる	セイライ丸	ja-JP
せいろんは	生論派	ja-JP
せかいしき	世界式	ja-JP
せかいにんむ	世界任務	ja-JP
せきかく	赤角	ja-JP
せきかくせきじんめっさい	赤角石塵滅砕	ja-JP
せきせつのみち	積雪の道	ja-JP
せきねん	赤念	ja-JP
せきねんのみ	赤念の実	ja-JP
せきはく	石珀	ja-JP
せきもん	石門	ja-JP
ぜつうんのま	絶雲の間	ja-JP
ぜつげん	絶弦	ja-JP
せっそうのみやこ	雪葬の都	ja-JP
せつなじゅし	刹那樹脂	ja-JP
せの	セノ	ja-JP
せれすてぃあ	セレスティア	ja-JP
せんがん	千岩	ja-JP
せんがんぐん	千岩軍	ja-JP
せんじんのさばく	千尋の砂漠	ja-JP
せんちょうしょう	仙跳牆	ja-JP
せんとうあくしょん	戦闘アクション	ja-JP
せんねんしんじゅのかいしゅん	千年真珠の海駿	ja-JP
せんぷうのしんでん	千風の神殿	ja-JP
せんようぎょくはく	旋曜玉帛	ja-JP
せんれい	仙霊	ja-JP
そうがんきょえん	層岩巨淵	ja-JP
そうきんかく	壮菌核	ja-JP
そうげきか	草激化	ja-JP
そうげんかく	草原核	ja-JP
そうしょうら	蒼晶螺	ja-JP
そうしん	草神	ja-JP
そうせいけっしょう	創世結晶	ja-JP
そうせんぎしき	送仙儀式	ja-JP
そうばくのゆうど	蒼漠の囿土	ja-JP
そうびかーど	装備カード	ja-JP
そうふうのこうち	蒼風の高地	ja-JP
そべくおあしす	ソベクオアシス	ja-JP
そるしゅ	ソルシュ	ja-JP
そろんは	素論派	ja-JP
だーりいせき	ダーリ遺跡	ja-JP
だーりのたに	ダーリの谷	ja-JP
だーるあるしふぁ	ダールアルシファ	ja-JP
だいいちこうりんしゃ	第一降臨者	ja-JP
だいさんこうりんしゃ	第三降臨者	ja-JP
たいだるが	タイダルガ	ja-JP
だいちきこう	大地紀行	ja-JP
だいにこうりんしゃ	第二降臨者	ja-JP
だいにちみこし	大日御輿	ja-JP
だいよんこうりんしゃ	第四降臨者	ja-JP
だいんすれいゔ	ダインスレイヴ	ja-JP
たかとびのはま	鷹飛びの浜	ja-JP
だくすいげんれい	濁水幻霊	ja-JP
だくすいふんさいのげんれい	濁水粉砕の幻霊	ja-JP
だくすいふんしゅつのげんれい	濁水噴出の幻霊	ja-JP
たけざい	竹材	ja-JP
だじゅう	駄獣	ja-JP
だだうぱのたに	ダダウパの谷	ja-JP
たたらすな	たたら砂	ja-JP
たにっとろえいち	タニット露営地	ja-JP
だまーゔぁんどさん	ダマーヴァンド山	ja-JP
たまりすくざい	タマリスク材	ja-JP
たらったかいていこく	タラッタ海底谷	ja-JP
たるたりや	タルタリヤ	ja-JP
たんしゃがい	丹砂崖	ja-JP
たんそくゆにっと	探測ユニット	ja-JP
ちえのかんむり	知恵の冠	ja-JP
ちぇるびっくあぷりしあ	チェルビックアプリシア	ja-JP
ちおり	千織	ja-JP
ちおりや	千織屋	ja-JP
ちかいのみさき	誓いの岬	ja-JP
ちかしつげん	地下湿原	ja-JP
ちこざかな	チ虎魚	ja-JP
ちじょうこうく	地上鉱区	ja-JP
ちぞめのきし	血染めの騎士	ja-JP
ちちゅうのしお	地中の塩	ja-JP
ちゃとらかむどうくつ	チャトラカム洞窟	ja-JP
ちゅうおうじっけんしつあとち	中央実験室跡地	ja-JP
ちょううん	重雲	ja-JP
ちょうげきか	超激化	ja-JP
ちょうさいえいごうどれいく	兆載永劫ドレイク	ja-JP
ちょうさいようごうどれいく	兆載永劫ドレイク	ja-JP
ちらいしゃでん	チライ社殿	ja-JP
ちれいだん	地霊壇	ja-JP
ちろんは	知論派	ja-JP
ちんぎょく	沈玉	ja-JP
ちんしゅのもり	鎮守の森	ja-JP
ちんわときょうこく	チンワト峡谷	ja-JP
つぁれーゔぃち	ツァレーヴィチ	ja-JP
つきおいさい	月逐い祭	ja-JP
つるみ	鶴観	ja-JP
でぃおな	ディオナ	ja-JP
でいさんだー	デイサンダー	ja-JP
でぃしあ	ディシア	ja-JP
てぃなり	ティナリ	ja-JP
てぃみー	ティミー	ja-JP
でぃるっく	ディルック	ja-JP
ていわっと	テイワット	ja-JP
でーゔぁーんたかやま	デーヴァーンタカ山	ja-JP
でからびあん	デカラビアン	ja-JP
てきかしゅう	荻花洲	ja-JP
てっこうようえんていおう	鉄甲熔炎帝王	ja-JP
てつなざん	鉄和山	ja-JP
てつほう	鉄蜂	ja-JP
てつほうのさし	鉄蜂の刺し	ja-JP
てんきゅうのたに	天穹の谷	ja-JP
てんくうきこう	天空紀行	ja-JP
てんこうきょう	天工峡	ja-JP
てんこうざん	天衡山	ja-JP
でんせつにんむ	伝説任務	ja-JP
てんとがめ	テントガメ	ja-JP
てんねんじゅし	天然樹脂	ja-JP
どういつげんそ	同一元素	ja-JP
とぅーるびよんそうち	トゥールビヨン装置	ja-JP
とうきょく	冬極	ja-JP
とうごく	冬極	ja-JP
どうじゃく	銅雀	ja-JP
どうてん	洞天	ja-JP
どうてんほうせん	洞天宝銭	ja-JP
とぅにぎのこくえん	トゥニギの黒淵	ja-JP
とぅらいとぅーら	トゥライトゥーラ	ja-JP
どぅらふ	ドゥラフ	ja-JP
どぅる・かるないんとうげ	ドゥル・カルナイン峠	ja-JP
どぅるかるないんとうげ	ドゥル・カルナイン峠	ja-JP
とうれいか	悼霊花	ja-JP
とーま	トーマ	ja-JP
どーれい	ドーレイ	ja-JP
とくじゅんたい	特巡隊	ja-JP
とくべつきょかけん	特別許可券	ja-JP
とげばらのかい	棘薔薇の会	ja-JP
とことこいわまっしゅろん	トコトコ岩マッシュロン	ja-JP
とことこみずまっしゅろん	トコトコ水マッシュロン	ja-JP
とこよのさや	常世の莢	ja-JP
とこよれいびょう	常夜霊廟	ja-JP
どっとーれ	ドットーレ	ja-JP
とてもあかるいばしょ	とても明るい場所	ja-JP
とてもあったかいばしょ	とてもあったかい場所	ja-JP
どどこ	ドドコ	ja-JP
どどりあん	ドドリアン	ja-JP
どにあざーど	ドニアザード	ja-JP
とびへび	トビヘビ	ja-JP
とらいすてーと	トライステート	ja-JP
どらごんすぱいん	ドラゴンスパイン	ja-JP
どりー	ドリー	ja-JP
とんぎょくのおか	遁玉の丘	ja-JP
どんせいのくじら	呑星の鯨	ja-JP
なゔぃあ	ナヴィア	ja-JP
なゔぃあせん	ナヴィア線	ja-JP
ながるじゅなだん	ナガルジュナ団	ja-JP
なぐさ	鳴草	ja-JP
なた	ナタ	ja-JP
なづちのはま	名椎の浜	ja-JP
なな	七七	ja-JP
なひーだ	ナヒーダ	ja-JP
なぶ・まりかった	ナブ・マリカッタ	ja-JP
なぶまりかった	ナブ・マリカッタ	ja-JP
なるかみおおやしろ	鳴神大社	ja-JP
なるかみじま	鳴神島	ja-JP
なるつぃっせんくろいつ	ナルツィッセンクロイツ	ja-JP
なるぼんぬえりあ	ナルボンヌエリア	ja-JP
なんてんもん	南天門	ja-JP
にーべるんげん	ニーベルンゲン	ja-JP
にぃろう	ニィロウ	ja-JP
にこ	ニコ	ja-JP
にこ・りやん	ニコ・リヤン	ja-JP
にわかつらぎ	丹羽桂木	ja-JP
ぬゔぃれっと	ヌヴィレット	ja-JP
ねこ	寝子	ja-JP
のうしゅくじゅし	濃縮樹脂	ja-JP
のえる	ノエル	ja-JP
ぱーゔぇず	パーヴェズ	ja-JP
ぱーゔぇずらゔぁん	パーヴェズラヴァン	ja-JP
ばーてぃんのちんきかん	バーティンの珍奇館	ja-JP
ばーばら	バーバラ	ja-JP
ばーべろす	バーベロス	ja-JP
はーるゔだん	ハールヴダン	ja-JP
はうすおぶはーす	壁炉の家	ja-JP
ばくえんじゅ	爆炎樹	ja-JP
はざまのまち	狭間の街	ja-JP
ぱたぱたくさまっしゅろん	パタパタ草マッシュロン	ja-JP
ぱたぱたこおりまっしゅろん	パタパタ氷マッシュロン	ja-JP
ばっせい	跋掣	ja-JP
はつつゆのみなもと	初露の源	ja-JP
ばつなん	伐難	ja-JP
はっらのみ	ハッラの実	ja-JP
ぱてぃさら	パティサラ	ja-JP
ばどるどー	バドルドー	ja-JP
はなちるさと	花散里	ja-JP
ぱねーす	パネース	ja-JP
ばぶるおれんじ	バブルオレンジ	ja-JP
ぱるじふぁる	パルジファル	ja-JP
ばるそむのおか	バルソムの丘	ja-JP
ぱるでぃすでぃあい	パルディスディアイ	ja-JP
はるのすけ	晴之介	ja-JP
ばるばとす	バルバトス	ja-JP
ぱれ・めるもにあ	パレ・メルモニア	ja-JP
ぱれめるもにあ	パレ・メルモニア	ja-JP
はんえいきゅうとうせいまとりっくす	半永久統制マトリックス	ja-JP
ばんがん	磐岩	ja-JP
ばんがんけつろく	磐岩結緑	ja-JP
ばんしゅぼじゅ	万種母樹	ja-JP
ばんのうげんそ	万能元素	ja-JP
ばんみんどう	万民堂	ja-JP
ぴえろ	ピエロ	ja-JP
ひおうきゅう	緋櫻毬	ja-JP
ひぎせいでん	秘儀聖殿	ja-JP
ひぎむら	緋木村	ja-JP
ひじょうのおか	避譲の丘	ja-JP
びゃくじゅつ	白朮	ja-JP
ひゃくにんいっき	百人一揆	ja-JP
ひゃっかちんぴん	百貨珍品	ja-JP
びゃっこのや	白狐の野	ja-JP
ひょうけいじゅつし	氷蛍術士	ja-JP
ひょうふうくみきょく	氷風組曲	ja-JP
ひらい	飛雷	ja-JP
ひらいのめいげん	飛雷の鳴弦	ja-JP
ひらうみとりで	平海砦	ja-JP
ひるちゃーる	ヒルチャール	ja-JP
ひるちゃーるれんじゃー	ヒルチャールレンジャー	ja-JP
ぴんばあや	ピンばあや	ja-JP
ふぁでゅい	ファデュイ	ja-JP
ふぁとぅす	ファトゥス	ja-JP
ふぁらくけるとのその	ファラクケルトの園	ja-JP
ふぁるか	ファルカ	ja-JP
ふぁるざん	ファルザン	ja-JP
ふぁんとむはんたー	ファントムハンター	ja-JP
ふぃっしゅる	フィッシュル	ja-JP
ふぃんどにーる	フィンドニール	ja-JP
ふうしゃあすたー	風車アスター	ja-JP
ふうしょくうぇねと	風蝕ウェネト	ja-JP
ふーたお	胡桃	ja-JP
ふーまい	フーマイ	ja-JP
ふうようけん	風鷹剣	ja-JP
ふうりゅうはいきょ	風龍廃墟	ja-JP
ふぉかろるす	フォカロルス	ja-JP
ふぉるとぅな	フォルトゥナ	ja-JP
ふぉんてーぬ	フォンテーヌ	ja-JP
ふぉんてーぬうんどうえねるぎーこうがくかがくけんきゅういんちく	フォンテーヌ運動エネルギー工学科学研究院地区	ja-JP
ふぉんてーぬかがくいん	フォンテーヌ科学院	ja-JP
ふぉんてーぬてい	フォンテーヌ廷	ja-JP
ふぉんてーぬていちく	フォンテーヌ廷地区	ja-JP
ぷかぷかかぜきのこん	プカプカ風キノコン	ja-JP
ぷかぷかくさきのこん	プカプカ草キノコン	ja-JP
ぷかぷかみずきのこん	プカプカ水キノコン	ja-JP
ぷくぷくじゅう	プクプク獣	ja-JP
ふごうのたに	伏鰲の谷	ja-JP
ふじとうとりで	藤兜砦	ja-JP
ふしゃ	浮舎	ja-JP
ぷすぱかふぇ	プスパカフェ	ja-JP
ぷねうま	プネウマ	ja-JP
ぷねうむしあ	プネウムシア	ja-JP
ぷねうむしあついしょうめつえねるぎー	プネウムシア対消滅エネルギー	ja-JP
ふぼくろ	不卜廬	ja-JP
ふめつのげっか	不滅の月華	ja-JP
ぷらいまるこうぞうたい	プライマル構造体	ja-JP
ふらいむ	フライム	ja-JP
ぶりーちゃーぷりむす	ブリーチャープリムス	ja-JP
ふりーな	フリーナ	ja-JP
ぷりゅいろーたす	プリュイロータス	ja-JP
ぷるちねっら	プルチネッラ	ja-JP
ふれみね	フレミネ	ja-JP
ぶろーちく	ブロー地区	ja-JP
ふろーらるりんぐだんさー	フローラルリングダンサー	ja-JP
へいぞう	平蔵	ja-JP
へうりあ	ヘウリア	ja-JP
へきすいのはら	碧水の原	ja-JP
へきろのいえ	壁炉の家	ja-JP
ぺっち	ペッチ	ja-JP
べねっと	ベネット	ja-JP
へびがみのくび	蛇神の首	ja-JP
べりるちく	ベリル地区	ja-JP
ほういんのおか	飽飲の丘	ja-JP
ほうじ	宝児	ja-JP
ぼうしくらげ	ボウシクラゲ	ja-JP
ぼうじょりょかん	望舒旅館	ja-JP
ほうとうだん	宝盗団	ja-JP
ぼうふうかいかく	望風海角	ja-JP
ぼうふうさんち	望風山地	ja-JP
ほうろうしゃ	放浪者	ja-JP
ぼうろうむら	望瀧村	ja-JP
ほうろうりょう	奔狼領	ja-JP
ぽーと・まるこっと	ポート・マルコット	ja-JP
ぽーとまるこっと	ポート・マルコット	ja-JP
ぼくそのはこ	睦疎の箱	ja-JP
ほくと	北斗	ja-JP
ほしおちのたに	星落ちの谷	ja-JP
ほしおとしのみずうみ	星落としの湖	ja-JP
ほしひろいのがけ	星拾いの崖	ja-JP
ほしほたるのどうくつ	星蛍の洞窟	ja-JP
ほてる・どぅぼーる	ホテル・ドゥボール	ja-JP
ほてるどぅぼーる	ホテル・ドゥボール	ja-JP
ぼふうのまっしゅるーむ	慕風のマッシュルーム	ja-JP
ほよゔぁーす	HoYoverse	ja-JP
ほよばーす	HoYoverse	ja-JP
ぽよよんいわきのこん	ポヨヨン岩キノコン	ja-JP
ぽよよんかぜきのこん	ポヨヨン風キノコン	ja-JP
ぽよよんかみなりきのこん	ポヨヨン雷キノコン	ja-JP
ぽよよんほのおきのこん	ポヨヨン炎キノコン	ja-JP
ぽわそんちょう	ポワソン町	ja-JP
まうてぃーまちゅうりん	マウティーマ稠林	ja-JP
まかいら	マカイラ	ja-JP
まぐうけんき	魔偶剣鬼	ja-JP
まぐうのしん	魔偶の芯	ja-JP
まこう	魔鉱	ja-JP
まさのり	公義	ja-JP
ましょう	魔晶	ja-JP
まじんにんむ	魔神任務	ja-JP
ますくしょう	マスク礁	ja-JP
まつざい	松材	ja-JP
まっしゅらぷとる	マッシュラプトル	ja-JP
まっしゅろん	マッシュロン	ja-JP
まはーるっかでゔぁーた	マハールッカデヴァータ	ja-JP
まらーな	マラーナ	ja-JP
まりあん	マリアン	ja-JP
まりんびょう	魔鱗病	ja-JP
まるこしあす	マルコシアス	ja-JP
まるこっとそう	マルコット草	ja-JP
まるしらっく	マルシラック	ja-JP
まれしょーせ・ふぁんとむ	マレショーセ・ファントム	ja-JP
まれしょーせふぁんとむ	マレショーセ・ファントム	ja-JP
まんまるたこ	マンマルタコ	ja-JP
みか	ミカ	ja-JP
みかげろしん	御影炉心	ja-JP
みこしちよ	御輿千代	ja-JP
みこしながまさ	御輿長正	ja-JP
みちあえのまつり	道饗祭	ja-JP
みぬ	弥怒	ja-JP
みほよ	miHoYo	ja-JP
みょうろんは	妙論派	ja-JP
みんきんかく	眠菌核	ja-JP
みんりん	珉林	ja-JP
むざふぁーる	ムザファール	ja-JP
むしょくげんそ	無色元素	ja-JP
むそうじんはざま	無想刃狭間	ja-JP
むそうのいかずち	無相の雷	ja-JP
むそうのいわ	無相の岩	ja-JP
むそうのかぜ	無相の風	ja-JP
むそうのくさ	無相の草	ja-JP
むそうのこおり	無相の氷	ja-JP
むそうのほのお	無相の炎	ja-JP
むそうのみず	無相の水	ja-JP
むひょうか	霧氷花	ja-JP
むひょうばな	霧氷花	ja-JP
むぼうのおか	無妄の丘	ja-JP
むみょうとりで	無明砦	ja-JP
むめいいせき	無名遺跡	ja-JP
むらたじん	ムラタ人	ja-JP
めいうんちょう	明蘊町	ja-JP
めいかんきょうこく	明冠峡谷	ja-JP
めいかんさんち	明冠山地	ja-JP
めいさいちょう	暝彩鳥	ja-JP
めいてい	命定	ja-JP
めいていち	命定値	ja-JP
めいろんは	明論派	ja-JP
めらっく	メラック	ja-JP
めりゅじーぬ	メリュジーヌ	ja-JP
めりゅしーむら	メリュシー村	ja-JP
めるもにあ	メルモニア	ja-JP
めろぴでようさい	メロピデ要塞	ja-JP
もううんじんじゃ	曚雲神社	ja-JP
もうじゃきょうろ	亡者狭路	ja-JP
もじゃもじゃだじゅう	モジャモジャ駄獣	ja-JP
もしりさいじょう	モシリ祭場	ja-JP
もな	モナ	ja-JP
もるてちく	モルテ地区	ja-JP
もんど	モンド	ja-JP
もんどじょう	モンド城	ja-JP
やえどう	八重堂	ja-JP
やえみこ	八重神子	ja-JP
やざだはいけ	ヤザダハ池	ja-JP
やしおりじま	ヤシオリ島	ja-JP
やしざい	ヤシ材	ja-JP
やすなゆうきょう	ヤスナ幽境	ja-JP
やちまたひこのち	八衢彦の地	ja-JP
やちまたひめのち	八衢姫の地	ja-JP
やどかに	ヤドカニ	ja-JP
ゆうとうたけ	ユウトウタケ	ja-JP
ゆうや	幽夜	ja-JP
ゆうやのわるつ	幽夜のワルツ	ja-JP
ゆぇーぐぇい	月桂	ja-JP
ゆくあき	行秋	ja-JP
ゆしき	諭示機	ja-JP
ゆしさいていかーでぃなる	諭示裁定カーディナル	ja-JP
ゆめみざい	夢見材	ja-JP
よいみや	宵宮	ja-JP
ようごうざん	影向山	ja-JP
ようこうのはま	瑶光の浜	ja-JP
よぉーよ	ヨォーヨ	ja-JP
よどまりいし	夜泊石	ja-JP
らいおんごんげん	雷音権現	ja-JP
らいきん	来歆	ja-JP
らいきんのよきょう	来歆の余響	ja-JP
らいけいじゅつし	雷蛍術師	ja-JP
らいでんえい	雷電影	ja-JP
らいでんしょうぐん	雷電将軍	ja-JP
らいでんまこと	雷電眞	ja-JP
らいめいせん	雷鳴仙	ja-JP
らぐゔぃんど	ラグヴィンド	ja-JP
らくか	落霞	ja-JP
らくらくだじゅう	ラクラク駄獣	ja-JP
らっか	落霞	ja-JP
らんばどさかば	ランバド酒場	ja-JP
りーゆえ	璃月	ja-JP
りーゆえこう	璃月港	ja-JP
りーゆえしちせい	璃月七星	ja-JP
りゔぃんぐすとん	リヴィングストン	ja-JP
りおせすり	リオセスリ	ja-JP
りさ	リサ	ja-JP
りしゃこう	璃沙郊	ja-JP
りしゅぼらんとら	リシュボラン虎	ja-JP
りすいじょうざんしんくん	理水畳山真君	ja-JP
りっしょうこんごうえねるぎー	律償混合エネルギー	ja-JP
りつほん	立本	ja-JP
りとう	離島	ja-JP
りね	リネ	ja-JP
りねっと	リネット	ja-JP
りふぃーちく	リフィー地区	ja-JP
りゅううんしゃくふうしんくん	留雲借風真君	ja-JP
りゅうのこ	リュウノコ	ja-JP
りゅうみんのたに	龍眠の谷	ja-JP
りよんえりあ	リヨンエリア	ja-JP
りりす	リリス	ja-JP
りるぱぁーる	リルパァール	ja-JP
りるふぁる	リルファル	ja-JP
りろーる	リロール	ja-JP
りんじほんこう	臨時本坑	ja-JP
るーすたん	ルースタン	ja-JP
るえとわーる	ルエトワール	ja-JP
るきなのいずみ	ルキナの泉	ja-JP
るっかでゔぁーただけ	ルッカデヴァータダケ	ja-JP
るね	ルネ	ja-JP
るみどぅーすはーばー	ルミドゥースハーバー	ja-JP
るみどぅーすべる	ルミドゥースベル	ja-JP
るりほう	瑠璃峰	ja-JP
るろうがくしょう	流浪楽章	ja-JP
れいくかん	霊矩関	ja-JP
れいこう	霊光	ja-JP
れいこうぜっしょう	霊光絶唱	ja-JP
れいこくぎ	霊谷木	ja-JP
れいこくぼく	霊谷木	ja-JP
れいら	レイラ	ja-JP
れいんどっと	レインドット	ja-JP
れいんぼーろーず	レインボーローズ	ja-JP
れざー	レザー	ja-JP
れつえんか	烈焔花	ja-JP
れつえんばな	烈焔花	ja-JP
れつかいか	烈開花	ja-JP
れっちゅうすなはら	列柱砂原	ja-JP
ろーえふぁるた	ローエファルタ	ja-JP
ろーかぱーらみつりん	ローカパーラ密林	ja-JP
ろーでしあ	ローデシア	ja-JP
ろーるふぇーず	ロールフェーズ	ja-JP
ろーれんす	ローレンス	ja-JP
ろくかのいけ	漉華の池	ja-JP
ろさりあ	ロサリア	ja-JP
ろざりん	ロザリン	ja-JP
ろざりん・くるーずちか・ろーえふぁるた	ロザリン・クルーズチカ・ローエファルタ	ja-JP
ろまりたいむはーばー	ロマリタイムハーバー	ja-JP
ろまりたいむふらわー	ロマリタイムフラワー	ja-JP
わくかうはま	ワクカウ浜	ja-JP
わたつみじま	海祇島	ja-JP
わはくえん	和璞鳶	ja-JP
わるか	ワルカ	ja-JP